#.###################
#.#...#.....#.#.#...#
#.###.#.#####.#.###.#
#.#.#.......#.......#
#.#.#.#############.#
#...#...#...#...#...#
###.###.#.###.#.###.#
#.#.....#.....#.#...#
#.#.###.###.#####.###
#.....#...#.....#.#.#
#.#####.#.#.#.###.#.#
#.#.#.#.#.#.#.#...#.#
#.#.#.#######.#.#.#.#
#...#...#.......#.#.#
#.#####.###.#.#.#.#.#
#...#.......#.#.#...#
###.#####.#.#.#.#.###
#...#.....#.#.#.#...#
#.#####.#.###.###.#.#
#.......#...#.#...#.#
###################.#